{
  "ህe": "ሀ",
  "ልe": "ለ",
  "ሕe": "ሐ",
  "ምe": "መ",
  "ሥe": "ሠ",
  "ርe": "ረ",
  "ስe": "ሰ",
  "ሽe": "ሸ",
  "ቅe": "ቀ",
  "ብe": "በ",
  "ቭe": "ቨ",
  "ትe": "ተ",
  "ችe": "ቸ",
  "ኅe": "ኀ",
  "ንe": "ነ",
  "ኝe": "ኘ",
  "እe": "አ",
  "ህu": "ሁ",
  "ልu": "ሉ",
  "ሕu": "ሑ",
  "ምu": "ሙ",
  "ሥu": "ሡ",
  "ርu": "ሩ",
  "ስu": "ሱ",
  "ሽu": "ሹ",
  "ቅu": "ቁ",
  "ብu": "ቡ",
  "ቭu": "ቩ",
  "ትu": "ቱ",
  "ችu": "ቹ",
  "ኅu": "ኁ",
  "ንu": "ኑ",
  "ኝu": "ኙ",
  "እu": "ኡ",
  "ህi": "ሂ",
  "ልi": "ሊ",
  "ሕi": "ሒ",
  "ምi": "ሚ",
  "ሥi": "ሢ",
  "ርi": "ሪ",
  "ስi": "ሲ",
  "ሽi": "ሺ",
  "ቅi": "ቂ",
  "ብi": "ቢ",
  "ቭi": "ቪ",
  "ትi": "ቲ",
  "ችi": "ቺ",
  "ኅi": "ኂ",
  "ንi": "ኒ",
  "ኝi": "ኚ",
  "እi": "ኢ",
  "ህa": "ሃ",
  "ልa": "ላ",
  "ሕa": "ሓ",
  "ምa": "ማ",
  "ሥa": "ሣ",
  "ርa": "ራ",
  "ስa": "ሳ",
  "ሽa": "ሻ",
  "ቅa": "ቃ",
  "ብa": "ባ",
  "ቭa": "ቫ",
  "ትa": "ታ",
  "ችa": "ቻ",
  "ኅa": "ኃ",
  "ንa": "ና",
  "ኝa": "ኛ",
  "እa": "ኣ",
  "ሀe": "ሄ",
  "ለe": "ሌ",
  "ሐe": "ሔ",
  "መe": "ሜ",
  "ሠe": "ሤ",
  "ረe": "ሬ",
  "ሰe": "ሴ",
  "ሸe": "ሼ",
  "ቀe": "ቄ",
  "በe": "ቤ",
  "ቨe": "ቬ",
  "ተe": "ቴ",
  "ቸe": "ቼ",
  "ኀe": "ኄ",
  "ነe": "ኔ",
  "ኘe": "ኜ",
  "አe": "ኤ",
  "h": "ህ",
  "l": "ል",
  "H": "ሕ",
  "m": "ም",
  "ስz": "ሥ",
  "r": "ር",
  "s": "ስ",
  "ስh": "ሽ",
  "q": "ቅ",
  "b": "ብ",
  "v": "ቭ",
  "t": "ት",
  "c": "ች",
  "X": "ኅ",
  "n": "ን",
  "ንy": "ኝ",
  ">": "እ",
  "ህo": "ሆ",
  "ልo": "ሎ",
  "ሕo": "ሖ",
  "ምo": "ሞ",
  "ሥo": "ሦ",
  "ርo": "ሮ",
  "ስo": "ሶ",
  "ሽo": "ሾ",
  "ቅo": "ቆ",
  "ብo": "ቦ",
  "ቭo": "ቮ",
  "ትo": "ቶ",
  "ችo": "ቾ",
  "ኅo": "ኆ",
  "ንo": "ኖ",
  "ኝo": "ኞ",
  "እo": "ኦ",
  "ላa": "ሏ",
  "ሓa": "ሗ",
  "ማa": "ሟ",
  "ሣa": "ሧ",
  "ራa": "ሯ",
  "ሳa": "ሷ",
  "ሻa": "ሿ",
  "ቃa": "ቇ",
  "ባa": "ቧ",
  "ቫa": "ቯ",
  "ታa": "ቷ",
  "ቻa": "ቿ",
  "ኃa": "ኇ",
  "ናa": "ኗ",
  "ኛa": "ኟ",
  "ኣa": "ኧ",
  "ክe": "ከ",
  "ኽe": "ኸ",
  "ውe": "ወ",
  "ዕe": "ዐ",
  "ዝe": "ዘ",
  "ዥe": "ዠ",
  "ይe": "የ",
  "ድe": "ደ",
  "ጅe": "ጀ",
  "ግe": "ገ",
  "ጥe": "ጠ",
  "ጭe": "ጨ",
  "ጵe": "ጰ",
  "ጽe": "ጸ",
  "ፅe": "ፀ",
  "ፍe": "ፈ",
  "ፕe": "ፐ",
  "ክu": "ኩ",
  "ኽu": "ኹ",
  "ውu": "ዉ",
  "ዕu": "ዑ",
  "ዝu": "ዙ",
  "ዥu": "ዡ",
  "ይu": "ዩ",
  "ድu": "ዱ",
  "ጅu": "ጁ",
  "ግu": "ጉ",
  "ጥu": "ጡ",
  "ጭu": "ጩ",
  "ጵu": "ጱ",
  "ጽu": "ጹ",
  "ፅu": "ፁ",
  "ፍu": "ፉ",
  "ፕu": "ፑ",
  "ክi": "ኪ",
  "ኽi": "ኺ",
  "ውi": "ዊ",
  "ዕi": "ዒ",
  "ዝi": "ዚ",
  "ዥi": "ዢ",
  "ይi": "ዪ",
  "ድi": "ዲ",
  "ጅi": "ጂ",
  "ግi": "ጊ",
  "ጥi": "ጢ",
  "ጭi": "ጪ",
  "ጵi": "ጲ",
  "ጽi": "ጺ",
  "ፅi": "ፂ",
  "ፍi": "ፊ",
  "ፕi": "ፒ",
  "ክa": "ካ",
  "ኽa": "ኻ",
  "ውa": "ዋ",
  "ዕa": "ዓ",
  "ዝa": "ዛ",
  "ዥa": "ዣ",
  "ይa": "ያ",
  "ድa": "ዳ",
  "ጅa": "ጃ",
  "ግa": "ጋ",
  "ጥa": "ጣ",
  "ጭa": "ጫ",
  "ጵa": "ጳ",
  "ጽa": "ጻ",
  "ፅa": "ፃ",
  "ፍa": "ፋ",
  "ፕa": "ፓ",
  "ከe": "ኬ",
  "ኸe": "ኼ",
  "ወe": "ዌ",
  "ዐe": "ዔ",
  "ዘe": "ዜ",
  "ዠe": "ዤ",
  "የe": "ዬ",
  "ደe": "ዴ",
  "ጀe": "ጄ",
  "ገe": "ጌ",
  "ጠe": "ጤ",
  "ጨe": "ጬ",
  "ጰe": "ጴ",
  "ጸe": "ጼ",
  "ፀe": "ፄ",
  "ፈe": "ፌ",
  "ፐe": "ፔ",
  "k": "ክ",
  "x": "ኽ",
  "w": "ው",
  "<": "ዕ",
  "z": "ዝ",
  "ዝh": "ዥ",
  "y": "ይ",
  "d": "ድ",
  "j": "ጅ",
  "g": "ግ",
  "ትh": "ጥ",
  "ችh": "ጭ",
  "ፕh": "ጵ",
  "ትs": "ጽ",
  "ትz": "ፅ",
  "f": "ፍ",
  "p": "ፕ",
  "ክo": "ኮ",
  "ኽo": "ኾ",
  "ውo": "ዎ",
  "ዕo": "ዖ",
  "ዝo": "ዞ",
  "ዥo": "ዦ",
  "ይo": "ዮ",
  "ድo": "ዶ",
  "ጅo": "ጆ",
  "ግo": "ጎ",
  "ጥo": "ጦ",
  "ጭo": "ጮ",
  "ጵo": "ጶ",
  "ጽo": "ጾ",
  "ፅo": "ፆ",
  "ፍo": "ፎ",
  "ፕo": "ፖ",
  "ኮe": "ኯ",
  "ዛa": "ዟ",
  "ዣa": "ዧ",
  "ዳa": "ዷ",
  "ጃa": "ጇ",
  "ጋa": "ጏ",
  "ጣa": "ጧ",
  "ጫa": "ጯ",
  "ጳa": "ጷ",
  "ጻa": "ጿ",
  "ፋa": "ፏ",
  "ፓa": "ፗ",
  "ቍe": "ቈ",
  "ኍe": "ኈ",
  "ኵe": "ኰ",
  "ዅe": "ዀ",
  "ጕe": "ጐ",
  "ቍi": "ቊ",
  "ኍi": "ኊ",
  "ኵi": "ኲ",
  "ዅi": "ዂ",
  "ጕi": "ጒ",
  "ቍa": "ቋ",
  "ኍa": "ኋ",
  "ኵa": "ኳ",
  "ዅa": "ዃ",
  "ጕa": "ጓ",
  "ቈe": "ቌ",
  "ኈe": "ኌ",
  "ኰe": "ኴ",
  "ዀe": "ዄ",
  "ጐe": "ጔ",
  "ቅw": "ቍ",
  "ኅw": "ኍ",
  "ክw": "ኵ",
  "ኽw": "ዅ",
  "ግw": "ጕ"
}
