{
  "a": "あ",
  "ka": "か",
  "ga": "が",
  "sa": "さ",
  "za": "ざ",
  "ta": "た",
  "da": "だ",
  "na": "な",
  "ha": "は",
  "ba": "ば",
  "pa": "ぱ",
  "ma": "ま",
  "ya": "や",
  "ra": "ら",
  "wa": "わ",
  "i": "い",
  "ki": "き",
  "gi": "ぎ",
  "shi": "し",
  "ji": "じ",
  "chi": "ち",
  "ni": "に",
  "hi": "ひ",
  "bi": "び",
  "pi": "ぴ",
  "mi": "み",
  "ri": "り",
  "u": "う",
  "ku": "く",
  "gu": "ぐ",
  "su": "す",
  "zu": "ず",
  "tsu": "つ",
  "nu": "ぬ",
  "fu": "ふ",
  "bu": "ぶ",
  "pu": "ぷ",
  "mu": "む",
  "ru": "る",
  "yu": "ゆ",
  "e": "え",
  "ke": "け",
  "ge": "げ",
  "se": "せ",
  "ze": "ぜ",
  "te": "て",
  "de": "で",
  "ne": "ね",
  "he": "へ",
  "be": "べ",
  "pe": "ぺ",
  "me": "め",
  "re": "れ",
  "o": "お",
  "ko": "こ",
  "go": "ご",
  "so": "そ",
  "zo": "ぞ",
  "to": "と",
  "do": "ど",
  "no": "の",
  "ho": "ほ",
  "bo": "ぼ",
  "po": "ぽ",
  "mo": "も",
  "yo": "よ",
  "ro": "ろ",
  "wo": "を",
  "nn": "ん",
  "kya": "きゃ",
  "kyu": "きゅ",
  "kyo": "きょ",
  "sha": "しゃ",
  "shu": "しゅ",
  "sho": "しょ",
  "cha": "ちゃ",
  "chu": "ちゅ",
  "cho": "ちょ",
  "nya": "にゃ",
  "nyu": "にゅ",
  "nyo": "にょ",
  "hya": "ひゃ",
  "hyu": "ひゅ",
  "hyo": "ひょ",
  "mya": "みゃ",
  "myu": "みゅ",
  "myo": "みょ",
  "rya": "りゃ",
  "ryu": "りゅ",
  "ryo": "りょ",
  "gya": "ぎゃ",
  "gyu": "ぎゅ",
  "gyo": "ぎょ",
  "ja": "じゃ",
  "ju": "じゅ",
  "jo": "じょ",
  "bya": "びゃ",
  "byu": "びゅ",
  "byo": "びょ",
  "pya": "ぴゃ",
  "pyu": "ぴゅ",
  "pyo": "ぴょ",
  "di": "ぢ",
  "du": "づ",
  "kk": "っ",
  "ss": "っ",
  "tt": "っ",
  "hh": "っ",
  "mm": "っ",
  "yy": "っ",
  "rr": "っ",
  "ww": "っ",
  "gg": "っ",
  "zz": "っ",
  "dd": "っ",
  "bb": "っ",
  "pp": "っ"
}
