{
  "a": "а",
  "b": "б",
  "v": "в",
  "g": "г",
  "d": "д",
  "e": "е",
  "е=": "ё",
  "зh": "ж",
  "z": "з",
  "i": "и",
  "j": "й",
  "k": "к",
  "l": "л",
  "m": "м",
  "n": "н",
  "o": "о",
  "p": "п",
  "r": "р",
  "s": "с",
  "t": "т",
  "u": "у",
  "f": "ф",
  "h": "х",
  "c": "ц",
  "цh": "ч",
  "сh": "ш",
  "w": "щ",
  "\"": "ъ",
  "y": "ы",
  "'": "ь",
  "ё=": "э",
  "йu": "ю",
  "йa": "я"
}
